{
  "width": 16,
  "height": 15,
  "tiles": [
    [2,1,1,1,1,1,1,1,1,1,1,1,1,1,1,3],
    [2,8,15,0,0,12,3,0,0,0,0,0,0,0,0,3],
    [2,8,0,0,0,9,3,0,0,0,0,0,0,0,0,3],
    [2,10,11,8,0,9,3,0,0,0,0,0,0,0,0,3],
    [2,6,6,6,13,6,3,0,0,0,0,0,0,0,0,3],
    [2,0,0,0,0,0,3,0,0,0,0,0,0,0,0,3],
    [2,0,0,0,0,0,3,0,0,0,0,0,0,0,0,3],
    [2,0,0,0,7,0,3,0,0,0,0,0,0,0,0,3],
    [2,0,0,0,0,0,3,0,0,0,0,0,0,0,0,3],
    [2,0,0,0,0,0,3,0,0,0,0,0,0,0,0,3],
    [4,6,6,13,6,6,5,0,0,0,0,0,0,0,0,3],
    [2,0,0,0,0,0,0,0,0,0,0,0,0,0,0,3],
    [2,0,0,0,0,0,0,0,0,0,0,0,0,0,0,3],
    [2,0,0,0,0,0,0,0,0,0,0,0,8,0,0,3],
    [4,6,6,6,6,6,6,6,6,6,6,6,16,6,6,5]
  ]
}
